A format is NEVER part of a data recovery or disk rebuild process and if done in such circumstances will normally lead to loss of all data on the disks being formatted=Formátování **NIKDY** není součástí procesu obnovy dat, nebo disku a pokud bude provedeno za těchto podmínek, tak povede ke ztrátě všech dat na discích které budete formátovat
Aborted=Přerušeno
Add=Přidat
Add Pool=Přidat fond
All existing data on this device will be OVERWRITTEN when array is Started=Všechna data na tomto zařízení budou při spuštění pole PŘEPSÁNA
Array Devices=Zařízení v poli
Array of %s devices=Pole o %s zařízeních
Array Operation=Ovládání pole
Attribute Name=Název atributu
Attributes=Atributy
Balance Status=Stav rozložení
Balance=Rozložení
Blacklisted=Na blacklistu
Boot Device=Spouštěcí zařízení
Boot system in UEFI mode=Spustit systém v režimu UEFI
btrfs balance status=stav rozložení systému btrfs
btrfs check status=stav kontroly systému btrfs
btrfs filesystem df=df systému btrfs
BTRFS operation is running=Běží operace BTRFS
btrfs scrub status=Stav vyčištění btrfs
Can not read attributes=Nemohu přečíst atributy
Can not read capabilities=Nemohu přečíst schopnosti
Can not read identification=Nemohu přečíst identifikaci
Canceled=Zrušeno
Cannot contact key-server Please check your=Nemohu se spojit s serverem pro vydávání klíčů. Prosím zkontrolujte
Capabilities=Schopnosti
Check Filesystem Status=Stav kontroly systému souborů
Clear Stats=Stav vyčištění
Clearing in progress=Probíhá čištění
Click to spin down device=Klepněte pro vypnutí zařízení
Click to spin up device=Klepněte pro zapnutí zařízení
Comments=Komentáře
complete=hotovo
Completed without error=Dokončeno bez chyby
Configuration valid=Nastavení je platné
Convert to raid0 mode=Převést na režim Raid0
Convert to raid1 mode=Převést na režim Raid1
Convert to raid10 mode=Převést na režim Raid10
Convert to raid5 mode see help=Převést na režim Raid5 *viz nápověda
Convert to raid6 mode see help=Převést na režim Raid6 *viz nápověda
Convert to single mode=Převést na režim jednoho disku
Copying=Kopíruji
corrected=opraveno
Create an empty file system on the disks shown as Unmountable discarding all data currently on the disks and update parity to reflect this=Vytvořit prázdný systém souborů, smazat všechna data a aktualizovat paritu na discích označených jako nepřipojitelné
Creating Flash backup=Vytvářím zálohu flash disku
creating Flash backup zip file this may take several minutes=Vytvářím záložní zip soubor flash disku (toto bude pár minut trvat)
Creation error=Chyba při vytváření
Critical disk temperature threshold=Práh kritické teploty disku
Critical disk utilization threshold=Práh kritického využití disku
Current operation %s on %s=Současná operace %s na **%s**
Current position=Současná pozice
Custom attributes use comma to separate numbers=Vlastní atributy (pro oddělení čísel použijte čárku)
Date of purchase=Datum pořízení
Date=Datum
Delete Pool=Smazat fond
detected=zjištěno
Device encrypted and unlocked=Zařízení zašifrováno a odemčeno
Device encrypted=Zařízení je zašifrováno
Device is part of a pool=Zařízení je součástí fondu
Device locked unknown error=Zařízení uzamčeno, neznámá chyba
Device locked wrong encryption key=Zařízení uzamčeno: chybný šifrovací klíč
Device to be encrypted=Zařízení k zašifrování
Disk in parity slot is not biggest=Zařízení ve slotu pro paritu není největší
Disk Log Information=Informace o záznamu disku
Do not use reserved names=Nepoužívejte vyhrazené názvy
Do not use user share names=Nepoužívejte názvy uživatelských sdílení
Download SMART report=Stáhnout hlášení SMART
Dual parity valid requires ALL disks in their original slots=Platná *dvojí parita* vyžaduje, aby byly **VŠECHNY** disky v jejich původních slotech
Elapsed time=Uplynulý čas
Enable user share assignment=Povolit přiřazení uživatelských sdílení
Erase=šifrovaný
Erase Device Content=Vstup šifrování
encrypted=Stav šifrování
Encryption input=Zadejte nový klíč
Encryption status=Vyskytly se chyby - Zkontrolujte hlášení SMART
Enter new key=Odhadované ukončení
Errors occurred - Check SMART report=Odhadovaná rychlost
Estimated finish=Selhalo
Estimated speed=Vlastnost
Existing content is permanently lost=Stav systému souborů
Failed=Typ systému souboru
Feature=Našla se: **%s** chyba
File system status=Našlo se: **%s** chyb
File system type=
Finding %s error=Záloha flash disku
Finding %s errors=Nastavení flash disku
Flag=Naformátovat nepřipojitelné disky
Flash backup=Formátuji
Flash Device Settings=formátuji
Format Unmountable disks=Volné
Formatting=Sys. soub.
formatting=Globální nastavení
Free=Skrýt
FS=Identifikace
Global Configuration=Identita
Hide=pokud je zaškrtnuté, tak se spustí pole, ale nepřipojí se disky
Identification=Pokud je toto nové pole, přesuňte disk do slotu pro paritu
Identity=Pokud přidáváte nový disk, nebo nahrazujete zakázaný disk, zkuste přehození parity
if checked, Start array but do not mount disks=
If this is a new array, move the largest disk into the parity slot=Informace
If you are adding a new disk or replacing a disabled disk, try Parity-Swap=Co nejdříve nainstalujte náhradní disk
If you want to preserve the data on the new disks, reset the array configuration and rebuild parity instead=Není k dispozici potřebné volné místo
Information=Přerušeno
Install a replacement disk as soon as possible=Neplatné nastavení
Insufficient free disk space available=Neplatné rozšíření
Interrupted=Neplatný název fondu
Invalid configuration=je k dispozici pouze po spuštění pole v **režimu údržby**
Invalid expansion=je k dispozici pouze po spuštění pole
Invalid pool name=Soubor s klíčem
is only available when array is Started in Maintenance mode=Poslední kontrola dokončena v **%s**
is only available when array is Started=Poslední kontrola nedokončena v **%s**
Keyfile=Naposledy zkontrolováno v **%s**
Last check completed on %s=Poslední výsledek testu SMART
Last check incomplete on %s=Režim údržby
Last checked on %s=Režim údržby
Last SMART test result=Údržba
Maintenance mode=Datum výroby
Maintenance Mode=Pohled nabídky
Maintenance=Minimální volné místo
Manufacturing date=Chybí cachovací disk
Menu View=Chybějící disk
Minimum free space=Chybějící klíč
Missing Cache disk=Chybějící
Missing disk=Připojený
Missing key=Přesouvač běží
Missing=nastavení sítě
Mounted=Zjištěny nové datové disky
Mover is running=Nebyly přiřazeny žádné datové disky
network settings=Žádné datové disky
New data disks detected=Není k dispozici historie kontrol parity
No array data disks have been assigned=Na tomto disku nejsou zapsány záznamy o auto-testech
No data disks=Nenainstalováno
No parity check history present=Poznámka: Pro názvy fondů nepoužívejte názvy, které jsou použité pro jako názvy sdílení
No self-tests logged on this disk=OK
Not installed=Až bude čištění dokončené, bude možné spustit pole a rozšířit ho o nové disky
Note do not use pool names which are also used as user share names=Až bude kopírování dokončené, bude možné spustit pole a zahájit obnovení dat zakázaného
OK=operace
Once clear completes, the array may be Started, expanding the array to include the new disks=Nastavení (viz Nápověda)
Once copy completes, the array may be Started, to initiate Data-Rebuild of the disabled disk=Jinak použijte metodu **souboru s klíčem** pro zadání UTF8
operation=Obsah disku s *paritou* bude přepsán
Options see Help=Parita je platná
Otherwise use the keyfile method for UTF8 input=Běží paritní operace
Parity disks content will be overwritten=*Platná parita* vyžaduje, aby **VŠECHNY** disky měly svůj původní obsah
Parity is already valid=Probíhá kontrola parity
Parity operation is running=Historie čtení / kontroly parity
Parity valid requires ALL disks to have their original content=Probíhá synchronizace parity / obnova dat
Parity-Check in progress=Formát oddílu
ParityRead-Check History=Velikost oddílu
Parity-SyncData-Rebuild in progress=Prošlo
Partition format=Přístupová fráze
Partition size=Provést plné vyrovnání
Passed=Povolit bootovací režim UEFI
Passphrase=Prosím zkontrolujte systémová nastavení, jestli podporují bootovací režim UEFI
Perform full balance=Zařízení fondu
Permit UEFI boot mode=Název fondu již existuje
Please check your system settings to support UEFI boot mode=Fond o %s zařízeních
Pool Devices=Probíhá předčištění
Pool name already exists=Pouze tisknutelné znaky
Pool of %s devices=Poračujte pro zahájení
Preclear in progress=Surová hodnota
Printable Characters Only=Surový pohled
Proceed to start=Probíhá kontrola čtení
Raw Value=Restartovat v nouzovém režimu
Raw View=registrační klíč
Read-Check in progress=Správce registračních klíčů
Reboot in safe mode=stav reiserfsck
registration key=Přejmenovat fond
Registration Key Manager=Přejmenovat
reiserfsck status=Opravit poškozené bloky
Rename Pool=Instalován náhradní disk
Rename=Náhradní disk je příliš malý
Repair corrupted blocks=Znovu napiště přístupovou frázi
Replacement disk installed=Plán
Replacement disk is too small=Stav čištění
Retype passphrase=Čištění
Schedule=Viz nastavení cache
Scrub Status=probíhá auto-test
Scrub=Auto-test
See Cache Settings=Bootovací režim serveru
self-test in progress=Nastavit výchozí bootovací nabídku
Self-Test=Zobrazit přístupovou frázi
Server boot mode=Zobrazit
Set default boot menu=Sloty
show passphrase=Upozornění atributu SMART
Show=Záznam chyb SMART
Slots=Rozšířený auto-test SMART
SMART attribute notifications=Kontrola zdraví SMART selhala
SMART error log=Hodnota upozornění SMART
SMART extended self-test=Historie auto-testů SMART
SMART health-check failed=Nastavení SMART
SMART notification value=Krátký auto-test SMART
SMART self-test history=Stav SMART
SMART Settings=Rychlost
SMART short self-test=Prodleva vypnutí
SMART status=Vypnout
Speed=Zapnout
Spin down delay=Skupiny zapnutí
Spin Down=Spuštěno, pole chráněno
Spin Up=Spuštěno, pole nechráněno
Spinup groups=Spuštěno, formátuji
Started, array protected=Spouštím
Started, array unprotected=Zastavuji
Started, formatting=Chyby synchronizace
Starting=Synchronizace
Stopping=Nastavení Syslinux
Sync errors=Nastavení Syslinux
Sync=Tepl.
Syslinux Configuration=Pole bude k dispozici okamžitě, ale bude **nechráněné**, z důvodu nepřiřazené parity
Syslinux configuration=Pole bude k dispozici okamžitě, ale bude **nechráněné** dokud nebude dokončena synchronizace parity
Temp=Náhradní disk musí být stejně velký, nebo větší, než originál
The array will be immediately available, but unprotected since parity has not been assigned=Toto se typicky provádí při přidání nového disku do pole, aby se připravil na zápis souborů
The array will be immediately available, but unprotected until Parity-Sync completes=Toto vydání unRAID Server OS bylo staženo a není možné ho nadále používat. Prosím %s aktualizujte svůj server
The replacement disk must be as big or bigger than the original=Tímto restartujete systém
This is typically done when a new disk is added to the array to get it ready for files to be written to it=Tímto vypnete systém
This unRAID Server OS release has been withdrawn and may no longer be used. Please %s update your server=Tímto zastavíte pole
This will ERASE ALL device content=Tímto zastavíte běžící operaci
This will ERASE content of ALL devices in the pool=Práh
This will reboot the system=Titulek
This will shutdown the system=Přepnout zobrazení čtení/zápisů
This will stop the array=Příliš mnoho připojených zařízení. Prosím proveďte povýšení své
This will stop the running operation=Příliš mnoho špatných a nebo chybějících disků
Threshold=Celková velikost
Title=Pro smazání tohoto fondu odeberte **VŠECHNA** zařízení
To confirm your action type %s=Nepřiřazená zařízení
Toggle readswrites display=není k dispozici (žádné záznamy o kontrole parity)
Too many attached devices Please consider upgrading your=Není k dispozici - disk musí být zapnutý
Too many wrong andor missing disks=Není k dispozici
Total size=Zjištěno nečisté vypnutí systému
Unassign ALL devices to delete this pool=Přítomen nepřipojitelný disk
Unassigned Devices=Přítomné nepřipojitelné disky
unavailable no parity-check entries logged=Nepřipojitelné: Je přítomný zašifrovaný oddíl
Unavailable - disk must be spun up=Nepřipojitelné: Chybí šifrovací klíč
Unavailable=Nepřipojitelné: Žádný systém souborů
Unclean shutdown detected=Nepřipojitelné: Žádné uuid fondu
Unmountable disk present=Nepřipojitelné: není fondem btrfs
Unmountable disks present=Nepřipojitelné: Oddíl není šifrovaný
Unmountable Encrypted volume present=Nepřipojený
Unmountable Missing encryption key=Aktualizuji disk / přehazuji paritu
Unmountable No file system=Použijte znaky **ASCII**, od mezery až po vlnovku
Unmountable No pool uuid=Použít výchozí
Unmountable not btrfs pool=Použít výchozí
Unmountable Volume not encrypted=Použijte pouze malá písmena bez zvláštních znaků a čísel na začátku, nebo na konci
Unmounted=Použijte pouze tisknutelné znaky
Upgrading diskswapping parity=Použito
Use ASCII characters from space to tilde=Hodnota
Use Default=VAROVÁNÍ: zrušení může ponechat pole nechráněné
Use default=Práh varování teploty disku
Use only lowercase with no special characters or leadingtrailing digits=Práh varování využití disku
use printable characters only=VAROVÁNÍ
Used=Záruční doba
Value=aktivuje čisté vypnutí systému
WARNING canceling may leave the array unprotected=aktivuje čistý reset sytému
Warning disk temperature threshold=spustí pole a zahájí **čištění** nových datových disků
Warning disk utilization threshold=spustí pole a zahájí **kontrolu parity**
WARNING=spustí pole a zahájí **synchronizaci parity** a nebo **obnovu dat**
Warranty period=spustí pole
will activate a clean system power down=zkopíruje informace o paritě na nový paritní disk
will activate a clean system reset=vytvoří systém souborů na všech nepřipojitelných discích
will bring the array on-line and start Clearing new data disks=smaže soubor šifrovacího klíče
will bring the array on-line and start Parity-Check=zakáže chybějící disk a spustí pole. Co nejdřive nainstalujte náhradní disk
will bring the array on-line and start Parity-Sync andor Data-Rebuild=rozšíří systém souborů datového disku; pokud to bude možné, spustí pole a zahájí obnovu dat
will bring the array on-line=smaže okamžitě všechny statistiky disku
will copy the parity information to the new parity disk=okamžitě spustí přesouvač
will create a file system in all Unmountable disks=okamžitě vypne všechny disky
will delete the encryption keyfile=okamžitě zapne všechny disky
will disable the missing disk and then bring the array on-line Install a replacement disk as soon as possible=pozastaví čištění
will expand the file system of the data disk if possible then bring the array on-line and start Data-Rebuild=pozastaví kontrolu parity
will immediately clear all disk statistics=pozastaví synchronizaci parity / obnovu dat
will immediately invoke the Mover=pozastaví kontrolu čtení
will immediately spin down all disks=zapíše všechny informace o discích a spustí pole
will immediately spin up all disks=zapíše všechny informace o discích, spustí pole a zahájí kontrolu parity
will pause the Clearing=zapíše všechny informace o nových discích, spustí pole a rozšíří ho
will pause the Parity-Check=odstraní chybějící cachovací disk a spustí pole
will pause the Parity-SyncData-Rebuild=obnoví pozastavené čištění
will pause the Read-Check=obnoví pozastavenou kontrolu parity
will record all disk information and bring the array on-line=obnoví pozastavenou synchronizaci parity / obnovu dat
will record all disk information, bring the array on-line, and start Parity-Sync=obnoví pozastavenou kontrolu čtení
will record the new disks information and bring the expanded array on-line=zahájí **čištění** nových datových disků
will remove the missing cache disk and then bring the array on-line=zahájí **kontrolu parity**
will resume the paused Clearing=zahájí **synchronizaci parity** a nebo **obnovu dat**
will resume the paused Parity-Check=zahájí **kontrolu čtení** na všech discích pole
will resume the paused Parity-SyncData-Rebuild=zahájí **kontrolu čtení** na všech datových discích
will resume the paused Read-Check=zastaví čištění
will start Clearing new data disks=zastaví synchronizaci parity / obnovu dat
will start Parity-Check=zastaví kontrolu parity
will start Parity-Sync andor Data-Rebuild=zastaví kontrolu čtení
will start Read-Check of all array disks=zastaví pole
will start Read-Check of all data disks=Nejhorší
will stop Clearing=Zapsat korekce parity
will stop Parity-SyncData-Rebuild=Zápisy
will stop the Parity-Check=Špatný klíč
will stop the Read-Check=stav opravy xfs
will take the array off-line=Nemůžete přidávat nové disky, ani odstraňovat stávající
Worst=váš server
Write corrections to parity=
Writes=
Wrong key=
xfs_repair status=
You may not add new disks and also remove existing disks=
your server=
