12 hours=12 hodin
24 hours=24 hodin
8023ad=802.3ad
Active Directory Settings=Nastavení Active Directory
Active Directory=Active Directory
active-backup=aktivní-záloha
Activate=Aktivovat
Activated=Aktivované
Activating=Aktivuji
AD account login=Přihlašovací jméno AD
AD account password=Heslo k AD
AD domain name=Doména AD
AD initial group=Úvodní skupina AD
AD initial owner=Úvodní vlastník AD
AD join status=Stav připojení k AD
AD short domain name=Krátký název domény AD
Add Route=Přidat směrování (route)
Add VLAN=Přidat VLAN
Agent function=Funkce agenta
Agents=Agenti
Alerts=Upozornění
Allow Remote Access=Povolit vzdálený přístup
and, the first and last characters must be alphanumeric=a první a poslední znak musí být alfanumerický
and=a
APC UPS Daemon user manual=Manuál k APC UPS Daemon
APCsmart=APCsmart
Applying=Používám
Apply to activate Docker after Array is Started=Použít pro start Dockeru po spuštění pole
Apply to activate VMs after Array is Started=Použít pro start virtuálních strojů po spuštění pole
Are you sure you want to erase all change history in both local and unraidnet remote=Opravdu chcete smazat všechnu historii změn jak z unraid.net, tak z místního systému?
Are you sure you want pause communication with your remote flash backup on unraidnet=Opravdu chcete pozastavit komunikaci se vzdálenou zálohou flash disku na unraid.net?
Array must be Stopped to change=Pro změnu musí být pole **zastavené**
Array status notification=Upozornění na stav pole
Array status=Stav pole
Assignment error=Chyba přiřazení
Attention=Pozor
Attribute=Atribut
Authentication method=Metoda ověření
Available notifications=Dostupná upozornění
balance-alb=
balance-rr=
balance-tlb=
balance-xor=
Bar color - Text=Barva panelu - Text
Bar color=Panel (barva)
Bar gray - Text=Barva panelu - Text
Bar gray=Panel (šedý)
Battery Charge=Nabití baterie
Battery level to initiate shutdown=Stupeň nabití baterie pro zahájení vypnutí
bfq=
Bonding members of=Členové bondingu
Bonding mode=Režim bondingu
Both=Oba
bottom-left=spodní levý
bottom-right=spodní pravý
Bridging members of=Členové přemostění
broadcast=vysílat
Browser=Prohlížeč
btrfs filesystem show=zobrazit systém souborů btrfs 
btrfs scrub status=stav čištění systému souborů btrfs
btrfs vDisk=btrfs vDisk
Cache disk not enabled=Cachovací disk není povolen
Cache Settings=Nastavení cache
Cannot provision cert that would overwrite your existing custom cert at=Nemohu opatřit certifikát, který by přepsal váš stávající vlastní certifikát v
Cannot renew cert until within 30 days of expiry=Certifikát nelze obnovit dříve než 30 dní před vypršením
Celsius=Celsius
center=střed
Certificate expiration=Vypršení certifikátu
Certificate issuer=Vydavatel certifikátu
Changes=Změny
Check cable=Zkontrolujte kabel
Check four times a day=Zkontrolovat čtyřikrát za den
Check once a day=Zkontrolovat jednou za den
Check once a month=Zkontrolovat jednou za měsíc
Check once a week=Zkontrolovat jednou za týden
Check twice a day=Zkontrolovat dvakrát za den
Checking=Kontroluji
Click here to see the Unraid Wiki for more information=Klepněte sem pro více informací na Unraid Wiki
Click to invoke the Mover=Klepnutím vyvoláte přesouvač
Click to select PNG file=Klepněte pro výběr PNG souboru
Click to Select=Klepněte pro výběr
configuring interface=nastavuji rozhraní
Confirm array stop command=Potvrdit příkaz zastavení pole
Confirm reboot powerdown commands=Potvrdit příkazy restart a vypnutí
Confirm sleep command=Potvrdit příkaz uspání
Confirmations=Potvrzení
Container=Kontejner
Content=Obsah
Correct file system errors=Opravit chyby systému souborů
CPU Isolation A reboot is required to apply changes=Izolace procesoru: Pro provedení změn je požadován restart
CPU isolation is prohibited while system is running in SAFE MODE=Izolace procesoru v NOUZOVÉM REŽIMU zakázána
CPU Isolation=Izolace procesoru
CPU Pinning Docker=Připnutí procesoru k Dockeru
CPU Pinning VM=Připnutí procesoru k virtuálnímu stroji
CPU Pinning=Připnutí procesoru
CRAM-MD5=CRAM-MD5
Current date and time=Aktuální datum a čas
Custom attributes use comma to separate numbers=Vlastní atributy (čísla oddělte čárkou)
Custom banner=Vlastní banner
Custom UPS cable=Vlastní kabel k UPS
Custom=Vlastní
custom=vlastní
D comma G dot=[D] čárka : [G] tečka
D comma G none=[D] čárka : [G] nic
D comma G space=[D] čárka : [G] mezera
D dot G comma=[D] tečka : [G] čárka
D dot G none=[D] tečka : [G] nic
D dot G space=[D] tečka : [G] mezera
Daily=Denně
Date and Time=Datum a čas
Date format=Formát data
Day of the month=Den v měsíci
Day of the week=Den v týdnu
Day, D Month YYYY=Den, D Měsíc
Day, DD.MM.YYYY=Den, DD.MM.YYYY
Day, DD-MM-YYYY=Den, DD-MM-YYYY
Day, MMDDYYYY=Den, MM/DD/YYYY
Day, Month D, YYYY=Den, Měsíc D, YYYY
Day, YYYY Month D=Den, YYYY Měsíc
Day, YYYY-MM-DD=Den, YYYY-MM-DD
DD-MM-YYYY=DD-MM-YYYY
Deactivate=Deaktivovat
Deactivating=Deaktivuji
Default appdata storage location=Výchozí umístění úložiště pro appdata
Default critical disk temperature threshold=Výchozí práh kritické teploty disku
Default critical disk utilization threshold=Výchozí práh kritického využití disku
Default file system=Výchozí systém souborů
Default ISO storage path=Výchozí cesta úložiště ISO obrazů
Default network bridge=Výchozí síťový most
Default partition format=Výchozí formát partice
Default SMART attribute notifications=Výchozí oznámení SMART atributu
Default SMART controller type=Výchozí typ SMART řadiče
Default SMART notification tolerance level=Výchozí oznámení SMART úrovně tolerance
Default SMART notification value=Výchozí hodnota oznámení SMART
Default spin down delay=Výchozí prodleva vypnutí
Default VM storage path=Výchozí cesta úložiště virtuálních strojů
Default warning disk temperature threshold=Výchozí práh varování teploty disku
Default warning disk utilization threshold=Výchozí práh varování využití disku
Default Windows VirtIO driver ISO=Výchozí ISO obraz Windows ovladačů VirtIO
Define a TLS certificate=Definujte TLS certifikát
Delete directory=Smazat složku
Delete Image File=Smazat soubor obrazu
Delete vDisk file=Smazat soubor vDisku
Delete VLAN=Smazat VLAN
Desired MTU=Žádané MTU
Detailed=Detailní
Device=Zařízení
DHCP pool=Fond DHCP
directory=složka
Disabled until you Provision an unraidnet SSL Cert and set SSL-TLS to Auto=Dokud si nevyžádáte SSL certifikát od unraid.net a nenastavít SSL-TSL na auto je tato volba zakázána
Disabled until your root user account is password-protected=Dokud nebude uživatel root chráněn heslem, bude tato volba zakázána.
Disk Settings=Nastavení disku
Display array totals=Zobrazit pole celkem
Display device name=Zobrazit název zařízení
Display position=Zobrazit pozici
Display Settings=Nastavení displeje
Display world-wide-name in device ID=Zobrazit celosvětový název v identifikátoru zařízení
Docker data-root=Data Dockeru - kořen
Docker directory=Složka Dockeru
Docker LOG maximum file size=Maximální velikost souboru záznamů Dockeru
Docker LOG number of files=Počet souborů záznamů Dockeru
Docker LOG rotation=Rotace souborů záznamů Dockeru
Docker only=Pouze Docker
Docker service=Služba Docker
Docker Stop Timeout=Prodleva vypnutí Dockeru
Docker update notification=Oznámení aktualizace Dockeru
Docker update=Aktualizace Dockeru
Docker vDisk location=Umístění vDisku Dockeru
Docker vDisk size=Velikost vDisku Dockeru
Docker version=Verze Dockeru
Docker VMs=Docker a virtuální stroje
Docker volume info=Informace o oddílu Dockeru
Docker will be available after Array is Started=Docker bude k dispozici až po spuštění pole
Docker=Docker
Download Windows VirtIO driver ISO=Stáhnout ovladače VirtIO pro Windows
Downstream=
Drag-n-drop a PNG file or click the image at the left=Přetáhněte sem PNG soubor, nebo klepněte na obrázek vlevo
Dumb=Hloupý
Dynamix color theme=Barevné téma Dynamix
Email recipients=Příjemci mailu
Email subject prefix=Předpona předmětu mailu
Email=Mail
Enable auto start=Povolit automatické spuštění
Enable bonding=Povolit bonding
Enable bridging=Povolit přemostění
Enable disk shares=Povolit disková sdílení
Enable Docker=Povolit Docker
Enable NetBIOS=Povolit NetBIOS
Enable NFS=Povolit NFS
Enable SMB=Povolit SMB
Enable spinup groups=Povolit skupiny zapnutí
Enable user shares=Povolit uživatelská sdílení
Enable VLANs=Povolit VLANy
Enable VMs=Povolit virtuální stroje
Enable WSD=Povolit WSD
encrypted=šifrované
Enhanced macOS interoperability=Rozšířená interoperabilita s macOS
Enter route + gateway + metric=Zadejte směrování (route) + bránu + metriku
Ether=Ether
Ethernet Port=Ethernetový port
Event=Událost
Every 2 hours=Každé 2 hodiny
Every 3 hours=Každé 3 hodiny
Every 4 hours=Každé 4 hodiny
Every 6 hours=Každých 6 hodin
Every 8 hours=Každých 8 hodin
Every day=Každý den
Every hour=Každou hodinu
Every month=Každý měsíc
Every week=Každý týden
exceeds Disk Shutdown=přesahuje vypnutí disku
Excluded disks=Vynechané disky
Execution error=Chyba vykonání
Failed to open=Chyba při otevírání
Failed to stop=Chyba při zastavování
Failure to do so may result in your docker image suffering corruption at a later time=Neprovedení může mít za následek pozdější porušení obrazu Dockeru
Fahrenheit=Fahrenheit
First day=První den
First week=První týden
Flash backup=Záloha flash disku
Font size=Velikost písma
Fourth week=Čtvrtý týden
FTP server=FTP server
FTP users=FTP uživatel(é)
Gateway=Brána
gateway name or address=název nebo adresa brány
Global Share Settings=Globální nastavení sdílení
Global SMART Settings=Globální nastavení SMART
has been created on unraidnet=byl vytvořen na unraidnetu
has been updated for unraidnet=byl aktualizován na unraidnetu
Header custom background color=Vlastní pozadí hlavičky
Header custom text color=Vlastní barva textu hlavičky
Header menu=Nabídka hlavičky
Header show description=Hlavička zobrazuje popisek
HHMM=HH:MM
Hibernate VMs=Hibernovat virtuální stroje
Hide dot files=Skrýt soubory s tečkou na začátku
Host access to custom networks=Hostitelský přístup k vlastním sítím
hosts=hostitelé
Hourly=každou hodinu
HTML color code of 3 or 6 hexadecimal digits=3 nebo 6 znaků dlouhý hexadecimální HTML kód
HTTP port=HTTP port
HTTPS port=HTTPS port
Huge=Velký
Identification=Identifikace
Importance=Důležitost
inactive=neaktivní
Included disks=Začleněné disky
Interface description=Popis rozhraní
Interface Rules=Pravidla rozhraní
Invalid email address=Neplatná mailová adresa
Invalid IPv4 gateway=Neplatná brána IPv4
Invalid IPv4 range=Neplatný rozsah IPv4
Invalid IPv4 subnet=Neplatná podsíť IPv4
Invalid IPv6 gateway=Neplatná brána IPv6
Invalid IPv6 range=Neplatný rozsah IPv6
Invalid IPv6 subnet=Neplatná podsíť IPv6
Invalid pool address=Neplatný fond adres
Invalid subnet size=Neplatná velikost podsíťe
IPv4nn or IPv6nn route=IPv4/nn nebo IPv6/nn směrování (route)
IPv4 address A.B.C.D=IPv4 adresa A.B.C.D
IPv4 address assignment=Přiřazení IPv4 adresy
IPv4 address=IPv4 adresa
IPv4 custom network on interface=Vlastní IPv4 síť na rozhraní
IPv4 default gateway=Výchozí brána IPv4
IPv4 DNS server assignment=Přiřazení DNS serveru IPv4
IPv4 DNS server=DNS server IPv4
IPv4 IPv6=IPv4 + IPv6
IPv4 only=Pouze IPv4
IPv6 address assignment=Přířazení IPv6
IPv6 address nnnnxxxxyyyy=IPv6 adresa nnnn:xxxx::yyyy
IPv6 address=IPv6 adresa
IPv6 custom network on interface=Vlastní IPv6 síť na rozhraní
IPv6 default gateway=Výchozí brána IPv6
IPv6 DNS server assignment=Přiřazení DNS serveru IPv6
IPv6 DNS server=DNS server IPv6
IPv6 only=Pouze IPv6
IPv6 privacy extensions=Rozšíření soukromí IPv6
is down=je offline
Isolated CPUs=Izolované procesory
Isolation=Izolace
Join=Spojit
Key=Klíč
kyber=kyber
Language=Jazyk
Language update=Aktualizace jazyka
Language update notification=Upozornění na aktualizaci jazyka
Large=Velký
Last day=Poslední den
Last week=Minulý týden
LE Cert Provisioned successfully=LE certifikát úspěšně opatřen
Leave=Opustit
Libvirt Log=Záznamy libvirt
Libvirt storage location=Umístění úložiště libvirt
Libvirt vdisk size=Velikost virtuálního disku libvirt
Libvirt version=Verze libvirt
Libvirt volume info=Informace o oddílu libvirt
License key required=Vyžadován licenční klíč
List of VLANs contains duplicate VLAN numbers=Seznam VLAN obsahuje duplicitní čísla
Listing height=Výška seznamu
Loading=Načítám
Local master=Místní hlavní
Local syslog folder=Místní složka syslog
Local syslog maximum file size=Maximální velikost místního souboru syslog
Local syslog number of files=Počet místních souborů syslog
Local syslog rotation=Rotace místních souborů syslog
Local syslog server=Místní syslog server
Local TLD=Místní doména TLD
Lost communication=Ztráta komunikace
MAC address=MAC adresa
MAC address mismatch=MAC adresa nesouhlasí
Mail server port=Port mail serveru
Mail server=Mail server
Management Access=Správcovský přístup
Manual=Ručně
may conflict with well-known services=může být v konfliktu se službou dobře známých
member of=člen
Metric=Metrika
Mirror syslog to flash=Zrcadlit syslog na flash disk
Missing subnet size=Chybějící velikost podsítě
MM-DD-YYYY=MM-DD-YYYY
ModBus=ModBus
Modify with caution unable to validate path until Array is Started=Pozor při změně: dokud nebude pole spuštěno, není možné ověřit cestu
Month of the year=Měsíc v roce
Monthly=Měsíčně
More information=Více informací.
Move now=Přesunout hned
Mover is running=Přesouvač běží
Mover logging=Záznamy přesouvače
Mover Settings=Nastavení přesouvače
Mover schedule=Časový plán přesouvače
mq-deadline=
Multi-function=Multi-funkce
must be a file directory provided=musíte poskytnout složku pro soubor
name or ip address=název nebo ip adresa
Net=Síť
Network protocol=Síťový protokol
Network Services=Síťové služby
Network Settings=Nastavení sítě
Never check=Nikdy nekontrolovat
Never send=Nikdy neodesílat
New date and time=Nové datum a čas
NFS=NFS
No battery detected=Nedekovaná žádná baterie
No Cache device present=Není přítomo cachovací zařízení
No Cache disk present=Není přítomen žádný cachovací disk
No CPU pinning available. Docker service must be started=Není k dispozici připínání procesoru. Služba Dockeru musí být spuštěna
No CPU pinning available. VM service must be started=Není k dispozici připínání procesoru. Služba virtuálních stroju musí být spuštěna
No Parity disk present=Není přítomen paritní disk
Nominal Power=Nominální výkon
Non-recommended port=Port mimo doporučené
Non-tabbed=Bez záložek
Not activated=Neaktivované
Not allowed to assign ZERO cores=Nelze přiřadit NULA jader
Not compatible with NetBIOS=Není kompatibilní s NetBIOS
not configured=nenakonfigurováno
not set=nenastaveno
Not up-to-date=Neaktuální
Nothing to do=Není co dělat
Notices=Upozornění
Notification Agents=Oznamovací agenti
Notification entity=Oznamovací entita
Notification Settings=Nastavení oznamování
Notifications display=Zobrazovat oznámení
NTP server=NTP server
Number format=Formát čísla
Number scaling=
Obtaining DNSv4 server=Získávám server DNSv4
Obtaining DNSv6 server=Získávám server DNSv6
Obtaining IPv4 address=Získávám adresu IPv4
Obtaining IPv4 gateway=Získávám bránu IPv4
Obtaining IPv6 address=Získávám adresu IPv6
Obtaining IPv6 gateway=Získávám bránu IPv6
obtaining=získávám
On battery=Na baterie
One or more paths do not exist=Jedna nebo více cest neexistují
Online boost=Online (boost)
Online trim=Online (trim)
Online=Online
Only alphanumeric characters=Pouze alfanumerické znaky
Only PNG images are allowed=Jsou povoleny pouze PNG obrázky
Oops=Ůps
optional metric lowest is preferred=volitelná metrika (upřednostňováno nejnižší)
optional metric lowest is preferred, 0 is no default gateway=volitelná metrika (upřednostňováno nejnižší, 0 je žádná výchozí brána)
Page view=Náhled stránky
Parity Check=Kontrola parity
Password=Heslo
Path does not exist=Cesta neexistuje
PCIe ACS override=Přepsání PCIe ACS
PCnet=PCnet
Placement of Users menu=Umístění nabídky uživatelů
Please disable the VM function=Prosím vypněte funkci virtuálního stroje
Please do this NOW=Prosím udělejte to HNED
Please enter a valid gateway=Prosím zadejte platnou bránu
Please enter a valid range=Prosím zadejte platný rozsah
Please enter a valid sending email address=Prosím zadejte platnou odesílající mailovou adresu
Please enter a valid subnet=Prosím zadejte platnou podsíť
Please note that the flash backup is not encrypted at this time=Upozornění: Záloha flash disku ještě není zakódována.
Please Reboot system to make new rules active=Pro aktivaci nových pravidel prosím **restartujte** systém
Plugins update notification=Oznámení o aktualizaci doplňků
Plugins update=Aktualizace doplňků
Pool address is out of range=Adresa fondu je mimo rozsah
Pool subnet size is not defined=Velikost fondu podsítě není definována
Pool subnet size is too large=Velikost fondu podsítě je moc velká
Port Down=
Port Up=
Preserve user defined networks=Zachovat uživatelsky definované sítě
Preset service=Přednastavená služba
Priority in header=Priorita v hlavičce
Protocol=Protokol
Provision=Obstarat
QEMU version=Verze QEMU
readmodifywrite=číst/měnit/zapisovat
reconstruct write=rekonstruovat zápis
Refreshing=Obnovuji
Registration key required=Je vyžadován registrační klíč
Reinitialize=Reinicializovat
Reinitializing=Reinicializuji
Remark configure your router with port forwarding of port=Poznámka: nastavte ve vašem routeru přesměrování portu
Remote syslog server=Odstranit server syslog
Remove Windows VirtIO driver ISO=Odstranit ISO s ovladači VirtIO pro Windows
resolution=rozlišení
Route=Směrování (route)
Routing Table=Směrovací tabulka
Rules=Pravidla
Rules contain duplicate MAC address assignments=Pravidla obsahují duplikát přiřazení MAC adresy
Runtime left to initiate shutdown=Zbývající doba běhu pro zahájení vypínání
Runtime Left=Zbývající doba běhu
Samba extra configuration=Extra nastavení Samby
Scheduled parity check=Naplánovaná kontrola parity
Scheduler=Plánovač
Scrub=Vyčistit
Second week=Druhý týden
See Help for more details and workarounds=Pro více detailů řešení se podívejte do nápovědy
see interface=viz rozhraní
Send crash information to Unraid developers=Odesílat informace o pádu vývojářům Unraidu
Send every hour=Odesílat každou hodinu
Send every two hours=Odesílat každé dvě hodiny
Send four times a day=Odesílat čtyřikrát za den
Send once a day=Odesílat jednou za den
Send once a month=Odesílat jednou za měsíc
Send once a week=Odesílat jednou za týden
Send three times a day=Odesílat třikrát za den
Send twice a day=Odesílat dvakrát za den
Sending email address=Odesílající mailová adresa
Server name=Název Serveru
Server was unable to provision SSL certificate=Server nemohl obstarat SSL certifikát
Setting disabled in safe mode=Nastavení je vypnuté v **nouzovém režimu**
Settings menu=Nabídka nastavení
Show array utilization indicator=Zobrazit indikátor využití pole
Show banner=Zobrazit banner
Show Dashboard apps=Zobrazit aplikace v panelu
Shutdown time-out=Čas do vypnutí
Shutdown VMs=Vypnout virtuální stroje
shutdown=vypnout
Simple=Jednoduchý
Small=Malý
Smart=Chytrý
SMB Extras=SMB Extra
SMB Settings=Nastavení SMB
SMB=SMB
SMTP Settings=Nastavení SMTP
SNMP=SNMP
Sorry, an error occurred in processing your SSL certificate=Omlouváme se, při zpracování SSL certifikátu došlo k chybě
Sorry, an error occurred updating unraidnet DNS records=Omlouváme se, při aktualizaci DNS záznamů unraidnet došlo k chybě
SSH port=SSH port
Start APC UPS daemon=Spustit daemona APC UPS
Start page=Počáteční stránka
Static=Statický
Stop %s to make changes, see=Pro provedení změn zastavte **%s**, viz
Store notifications to flash=Ukládat oznámení na flash disk
Subject=Předmět
Subnet=Podsíť
success=úspěch
Summarized=Souhrn
Syslog Server=Server syslog
System notifications=Systémová oznámení
System Setting=Systémové nastavení
System Settings=Systémová nastavení
Tabbed=Záložky
TCP=TCP
TELNET port=TELNET port
Temperature unit=Jednotka teploty
Template Authoring Mode=Režim úpravy šablony
Test=Test
Test running=Test běží
Text - Bar color=Text - Řádka (barva)
Text - Bar gray=Text - Řádka (šedá)
Text=Text
Third week=Třetí týden
This is required to create VMs in KVM=Toto je požadováno pro vytvoření virtuálního stroje v KVM
this mode requires a network switch with proper setup and support=tento režim požaduje síťový switch se správnými nastaveními a podporou
This Unraid Server was unreachable from the outside=Tento Unraid server byl zvenčí nedosažitelný
Time format=Formát času
Time of the day=Čas
Time on battery before shutdown=Čas na baterii před vypnutím
Time zone=Časová zóna
time-out=time-out
Timestamp=Časové razítko
TLS certificate location=Umístění TLS certifikátu
to=do
Toggle thread to containers=Přepnout vlákno kontejnerům
top-left=horní levý
top-right=horní pravý
Tunable enable Direct IO=Nastavitelný (povolit Direct IO)
Tunable enable NCQ=Nastavitelný (povolit NCQ)
Tunable fuse_remember=Nastavitelný (fuse_remember)
Tunable md_num_stripes=Nastavitelný (md_num_stripes)
Tunable md_queue_limit=Nastavitelný (md_queue_limit)
Tunable md_sync_limit=Nastavitelný (md_sync_limit)
Tunable md_write_method=Nastavitelný (md_write_method)
Tunable nr_requests=Nastavitelný (nr_requests)
Tunable poll_attributes=Nastavitelný (poll_attributes)
Tunable scheduler=Nastavitelný (scheduler)
Tunable support Hard Links=Nastavitelný (podpora Hard Linků)
Turn off UPS after shutdown=Po vypnutí vypnout i UPS
UDP=UDP
; Keep the original plugin name in settings
Unable to register this Unraid Server=Nemohu zaregistrovat tento Unraid server
Unassigned Devices=Nepřiřazená zařízení
Unraid OS update notification=Oznámení o aktualizaci Unraid OS
Unraid OS update=Aktualizace Unraid OS
Unraidnet Status=Stav Unraid.net
Update DNS=Aktualizovat DNS
updating=aktualizuji
Updating=Aktualizuji
Upon host shutdown=Při vypnutí hostitele
UPS cable=Kabel UPS
UPS Details=Detaily UPS
UPS Load=Zátěž UPS
UPS Settings=Nastavení UPS
UPS Status=Stav UPS
UPS type=Typ UPS
USB=USB
Use cache device=Použít cache zařízení
Use image name dockerimg or docker-xfsimg or select a folder=Použijte název obrazu docker.img nebo docker-xfs.img nebo vyberte složku
Use NTP=Použít NTP
Use SSH=Použít SSH
Use SSLTLS=Použít SSL/TLS
Use STARTTLS=Použít STARTTLS
Use TELNET=Použít TELNET
Use UPnP=Použít UPnP
Used Free columns=Použité / Volné sloupce
User Preferences=Uživatelské nastavení
User shares not enabled=Uživatelské sdílení není povolené
User Utilities=Uživatelské nástroje
Username=Uživatelské jméno
user-set=nastavené uživatelem
value must be a number=hodnota musí být číslo
Value=Hodnota
Very large=Velmi velký
Very small=Velmi malý
VFIO allow unsafe interrupts=Povolit nebezpečná přerušení VFIO
View libvirt log=Zobrazit záznam libvirt
view=zobrazit
VLAN assignment mismatch=Nesoulad přiřazení VLANy
VLAN number=Číslo VLANy
VM Manager=Správce virtuálních strojů
VM manager=Správce virtuálních strojů
VM shutdown time-out=Time-out vypnutí virtuálních strojů
VM=Virtuální stroj
VMs only=Pouze virtuální stroje
VMs will be available after Array is Started=Virtuální stroje budou k dispozici až po spuštění pole
VPN Manager=Správce VPN
WAN Port=WAN Port
Warnings=Varování
Watts=Watty
Week of the month=Týden v měsíci
Weekly=Týdně
Workgroup Settings=Nastavení pracovní skupiny
Workgroup=Pracovní skupina
Write corrections to parity disk=Zapsat opravy na paritní disk
WSD options experimental=Nastavení WSD (pokusné)
xfs vDisk=xfs vDisk
Yearly=Ročně
Your existing Docker image file needs to be recreated due to an issue from an earlier beta of Unraid 6=Z důvodu chyby v předcházející beta verzi Unraid 6 je nutné znovu vytvořit stávající obraz Dockeru
Your hardware does not have Intel VT-x or AMD-V capability=Váš hardware nemá virtualizační technologii Intel VT-x nebo AMD-V
Your Lets Encrypt SSL Certificate has been provisioned and a DNS record for local IP address=Byl obstarán SSL certifikát Lets Encrypt a DNS záznam pro místní IP adresu
Your Lets Encrypt SSL Certificate has been renewed=Váš certifikát Lets Encrypt byl obnoven
Your local IP address=Vaše místní IP adresa
Your router or DNS server has DNS rebinding protection enabled, preventing=Váš router, nebo DNS server má povolenu ochranu před rebindingem, což znemožňuje
Your server has been registered=Váš server byl zaregistrován
Your Unraid Server is reachable from the internet=Váš Unraid server je dosažitelný z internetu
YYYY-MM-DD=YYYY-MM-DD
